010x010

130 128 129 129 128 130 128 128 129 131
129 000 128 000 130 000 128 001 003 129
129 000 128 000 131 000 129 128 000 129
128 000 130 000 130 000 128 128 000 130
128 000 130 006 001 008 128 130 000 129
128 006 001 008 131 006 001 007 008 130
128 000 130 006 001 008 129 005 008 130
129 006 001 008 128 000 130 128 000 128
128 000 129 000 128 000 128 129 000 130
128 129 131 129 130 129 128 131 129 131
